000000000000000000000000
000000000000500000000000
000400000000000000000400
000000000000000000000000
000000001111111000000000
000000001002001000000000
000500001300001000000500
000000001111111000000000
000000000000000000000000
000000000000500000000000
000400000000000000000400
000000000000000000000000
